1 1 1 1 1 1 1 1 1 1 1 1 1 1 1 1 
1 0 0 1 1 0 0 0 0 0 0 0 0 0 0 1 
1 0 0 1 1 0 0 0 0 0 1 1 0 0 1 1 
1 0 0 1 0 0 0 1 0 0 0 1 0 1 0 1 
1 1 1 1 0 1 0 0 0 0 0 0 0 0 0 1 
1 0 0 1 0 0 0 0 0 1 1 1 1 1 1 1 
1 0 1 1 0 0 0 1 1 1 0 0 0 0 0 1 
1 1 0 1 0 0 1 1 0 0 0 0 0 1 1 1 
1 0 0 0 0 0 0 1 0 0 0 1 0 0 0 1 
1 0 1 1 1 1 1 1 0 0 0 0 0 1 1 1 
1 0 0 1 0 0 0 0 0 1 1 1 0 0 0 1 
1 0 0 1 1 0 1 1 0 1 0 1 0 1 1 1 
1 0 1 0 0 0 0 1 1 0 1 1 0 0 2 1 
1 0 1 0 1 0 0 0 0 0 0 0 0 1 1 1 
1 0 0 0 1 0 0 0 0 0 0 0 0 1 0 1 
1 1 1 1 1 1 1 1 1 1 1 1 1 1 1 1 
20
4 2
3 2
2 2
2 3
2 4
3 4
4 4
4 5
4 6
4 7
3 7
3 8
3 9
3 10
3 11
3 12
3 13
4 13
4 14
4 15
